{
  "v1": {
    "1": "A",
    "2": "C",
    "3": "D",
    "4": "B",
    "5": "A",
    "6": "B",
    "7": "D",
    "8": "C"
  },
  "v2": {
    "1": "C",
    "2": "A",
    "3": "B",
    "4": "D",
    "5": "A",
    "6": "C",
    "7": "B",
    "8": "D"
  }
}
