{
  "v1": {
    "1": "A",
    "2": "C",
    "3": "D",
    "4": "B",
    "5": "A",
    "6": "B",
    "7": "D",
    "8": "C"
  }
}